#  This file lists scripts that have been deleted from version control.
#
#  The format is "path/to/deleted/script<tab>reason_for_deletion"

scripts/compare_gene_id.pl	uses non-existent Bio::Otter::DBSQL::* modules
scripts/conversion/assembly/accs2chromosomes.pl	obsolete
scripts/conversion/assembly/accs2fakeassembly.pl	obsolete
scripts/conversion/assembly/add_assembly.pl	obsolete
scripts/conversion/assembly/align_by_clone_identity.pl	obsolete
scripts/conversion/assembly/align_nonident_regions.pl	obsolete
scripts/conversion/assembly/assembly_exception.pl	obsolete
scripts/conversion/assembly/assembly_tags.pl	obsolete
scripts/conversion/assembly/blastz_matrix.txt	obsolete
scripts/conversion/assembly/check_ensembl_vega_projection.pl	obsolete
scripts/conversion/assembly/count_transferred_genes.pl	obsolete
scripts/conversion/assembly/finish_ensembl_vega_db.pl	obsolete
scripts/conversion/assembly/fix_overlaps.pl	obsolete
scripts/conversion/assembly/get_chr_seq.pl	obsolete
scripts/conversion/assembly/make_combined_assembly.pl	obsolete
scripts/conversion/assembly/make_ensembl_vega_db.pl	obsolete
scripts/conversion/assembly/map_annotation.pl	obsolete
scripts/conversion/assembly/modules/BlastzAligner.pm	obsolete
scripts/conversion/assembly/modules/Deletion.pm	obsolete
scripts/conversion/assembly/modules/Gene.pm	obsolete
scripts/conversion/assembly/modules/InterimExon.pm	obsolete
scripts/conversion/assembly/modules/InterimTranscript.pm	obsolete
scripts/conversion/assembly/modules/Length.pm	obsolete
scripts/conversion/assembly/modules/StatLogger.pm	obsolete
scripts/conversion/assembly/modules/StatMsg.pm	obsolete
scripts/conversion/assembly/modules/Transcript.pm	obsolete
scripts/conversion/assembly/modules/Utils.pm	obsolete
scripts/conversion/assembly/set_chr_lens.pl	obsolete
scripts/conversion/assembly/transfer_clone_annotation.pl	obsolete
scripts/conversion/assembly/transfer_ens_annotation.pl	obsolete
scripts/conversion/assembly/transfer_identical_chromosomes.pl	obsolete
scripts/conversion/change_analysis_by_stable_id.pl	obsolete
scripts/conversion/change_otterid_namespace.pl	obsolete
scripts/conversion/delete_genes.pl	obsolete
scripts/conversion/delete_redundant_vega_tables.pl	obsolete
scripts/conversion/ensembl2gtf	obsolete
scripts/conversion/evidence/check_evidence.pl	obsolete
scripts/conversion/evidence/evidence_to_support.pl	obsolete
scripts/conversion/fix_exon_ids.pl	obsolete
scripts/conversion/fixagp.pl	obsolete
scripts/conversion/gtf2ensembl	obsolete
scripts/conversion/loutre/cleanup_pipeline_dump	obsolete
scripts/conversion/loutre/compare_databases	obsolete
scripts/conversion/loutre/config.conf	obsolete
scripts/conversion/loutre/dump_loutre	obsolete
scripts/conversion/loutre/dump_pipeline	obsolete
scripts/conversion/loutre/finish_vega_creation	obsolete
scripts/conversion/loutre/patch_51_49.sql	obsolete
scripts/conversion/loutre/prepare_loutre	obsolete
scripts/conversion/loutre/vega_regions.txt	obsolete
scripts/conversion/newschema/ensembl2gtf	obsolete
scripts/conversion/otter2agp	obsolete
scripts/conversion/parse_chr21	obsolete
scripts/conversion/parse_chr22	obsolete
scripts/conversion/parse_gtf	obsolete
scripts/conversion/parse_thot	obsolete
scripts/conversion/parse_thot_with_seq	obsolete
scripts/conversion/testing/get_stats.pl	obsolete
scripts/conversion/testing/get_trans.pl	obsolete
scripts/conversion/trim_align_features.pl	obsolete
scripts/conversion/update_attributes.pl	obsolete
scripts/conversion/xref/add_ccds_xrefs.pl	obsolete
scripts/conversion/xref/add_ensembl_mappings.pl	obsolete
scripts/conversion/xref/add_external_xrefs.pl	obsolete
scripts/conversion/xref/add_gene_synonyms.pl	obsolete
scripts/conversion/xref/add_go_xrefs.pl	obsolete
scripts/conversion/xref/add_havana_xrefs.pl	obsolete
scripts/conversion/xref/add_vega_xrefs.pl	obsolete
scripts/conversion/xref/fix_transcript_names.pl	obsolete
scripts/conversion/xref/patch_mouse_WU_genes.pl	obsolete
scripts/conversion/xref/update_external_dbs.pl	obsolete
scripts/conversion/xref/update_mouse_gene_names.pl	obsolete
scripts/conversion/xref/update_transcript_names.pl	obsolete
scripts/dump_XML	uses the non-existent Bio::Otter::Converter module
scripts/ens2otter	uses non-existent Bio::Otter::DBSQL::* modules
scripts/from_otter	uses the non-existent Bio::Otter::Converter module
scripts/game2otter	uses the non-existent Bio::Otter::Converter module
scripts/get_region	uses the non-existent Bio::Otter::Converter module
scripts/jig_genes	uses the non-existent Bio::Otter::Converter module
scripts/lace/copy_translation	uses the non-existent Bio::Otter::Converter module
scripts/lace/dump_otter_SFeature_Atag_by_assembly	uses the non-existent Bio::Otter::Converter module
scripts/lace/load_new_gene_xml	uses the non-existent Bio::Otter::Converter module
scripts/lace/realign_missing_genes	uses the non-existent Bio::Otter::Converter module
scripts/lace/realign_offtrack_cdna_genes	uses the non-existent Bio::Otter::Converter module
scripts/lace/realign_offtrack_genes	uses the non-existent Bio::Otter::Converter module
scripts/lace/transfer_MHC_annotation.pl	uses the non-existent Bio::Otter::Converter module
scripts/lace/update_genes	uses the non-existent Bio::Otter::Converter module
scripts/loadXML	uses the non-existent Bio::Otter::Converter module
scripts/loadXML_on_slice	uses the non-existent Bio::Otter::Converter module
scripts/make_assembly	uses the non-existent Bio::Otter::Converter module
scripts/make_otter	uses non-existent Bio::Otter::DBSQL::* modules
scripts/make_otter_xml	uses the non-existent Bio::Otter::Converter module
scripts/setup_meta	uses non-existent Bio::Otter::DBSQL::* modules
scripts/test_server	uses the non-existent Bio::Otter::Converter module
scripts/to_otter	uses the non-existent Bio::Otter::Converter module
scripts/to_otter_slice	uses the non-existent Bio::Otter::Converter module
scripts/truncate_to_slice_test.pl	uses non-existent Bio::Otter::DBSQL::* modules
scripts/user_access	uses non-existent Bio::Otter::DBSQL::* modules
scripts/vega/missing_zfin_to_xrefs.pl	uses non-existent Bio::Otter::DBSQL::* modules
scripts/vega/transfer_clone_remark.pl	uses non-existent Bio::Otter::DBSQL::* modules
scripts/vega/zfin_to_xrefs.pl	uses non-existent Bio::Otter::DBSQL::* modules
scripts/write_region	uses the non-existent Bio::Otter::Converter module
